11000000000
11440000000
04044000000
00004000000
00004400000
00004400000
00000000000
00000000000
00000000000
00000000003
00000000033