11111111111000000000000
13333333331000000000000
13333333331000000000000
13333333331000000000000
13333333331000000000000
13333333331000000000000
13333333331000000000000
13333333331000000000000
13333333331000000000000
13333333331000000000000
11111111111000000000000
00002200000000000000000
00002200000000000000000
00002200000000000000000
00002200000000000000000
00002200000000000000000
00002200000000000000000
55555555555555555555555
00000000000000000000333
00000000000000000000333
00000000000000000000333