11111111111
00000000000
22222222222
00000000000
33333333333
00000000000
00000000000
44444444444
00000000000
00000000000
55555555555