555000000000333333333333300000000000333300000000333330000000
525111111113333333333333300000000033333330000000033330000000
555000000000333333333333330000000333333333000000333330000000
000000000003333333333333300000003333333333300003333333000000
000000033333333333333000000000003333333333333333333333000000
000003333333333333311111111111133333333333333333333333300000
333333333333333330000000000000333333333333333333333333300000
333333333333333330000000000003333333333333333333333333330000
333333333333333300000000000033333000333333333333333333330000
333333333333333000000000000333333000033333333333333333330000
333333333333333000000000003333333000003333333333333333330000
333333333333330000000000033333333000003333333333333333330000
333333333333300000000000333333333300333333300000333333333000
003333333330000000000000333333333333333333000000000000333333
000033333300000000000003333333333333333330000000000000033333
000003333000000000000033333333333333333330000000000000003333
000000031100000000000033333333333333333330000000000000003333
000000000100000000000333333333333333333300000000000000003333
000000000100000000000333333333333333333300000000000000000333
000000004440000000003333333333333333333300000000000000000003
000000004444000000033333333333333333333000000000000003000000
000000044444400000333333300033333333330000000000003333300000
000000044444400000333333000003333333330000000000033333330000
300000044444400003333333000000333333300000000000033333330000
300000004444400000333333300000333333300000000000333333330000
000000004444111111333333300000333333111111111111333333333000
300000000000000000333333330003333333000000000000033333333000
300000000000000000333333333333333333000000000000033333333000
330000000000000000333333333333333333000000000000033333333000
330000000000000000333333333333333333300000000000003333333000
330000000000000000333333333333333333333000000000003333330000
333000000000000000333333333333333333333300000000000033000000
330000000000000003333333333333333333333330000000000000000000
330000000000000033333333333333333333333333000000000000000000
330000000000000333333333333333333333333333000000000000000000
300000000000003333333333333333333333333333000000000000000000
300000000000333333333300333333333333300000000000333333330000
000000000000333333333000000333300000000000000033333333333333
000000000003333333333000000000000000000000000333333333333333
000000000003333333333000000000000000000000000333333333333333
000000000003333333333000000000000000000000003333333333333333
000000000000333333333000000000000000000000003333333333333333
000000000000033333333300000000000000000000003333333333333333
000000000000003333333330000000000000000000003333333333333333
000000000000000333333333000000000000000000003333333333333333
000000000000000333333333000000000000000000033333333333333333
000300000000000333333333300000000000000000033333330033333333
033333000000003333333333300000003333000000033333300003333333
333333330000333333333333300000033333300000033333300003333333
333333333333333333333333000000033333300000033333000000333333
333333333333333333333333300000333333330000033333000000033330
333333333333333333333333300000333333331111133330000000000000
333333333333333333333333330000333333333000003330000000000000
333333333333333333333333333003333333330000000330000000000000
333333333333333333333333333333333333330000000030000000000000
333333333000333333333333333333333333300000000000000000000000
333333333000003333333333333333333333300000000003000003000000
333333330000003333333333333333333333000000000003333333330000
333333330000003333333333333000333333000000000003333333333300
333333330000003333333333300000333333000000000003333333333330
